index,month1,month2,month3,month4,month5,month6,month7,month8
0,80,99,150,211,310,442,656,901
1,53,57,76,86,95,123,164,189
2,17,25,31,42,70,94,127,195
3,10,17,38,66,113,176,289,408
4,0,0,5,17,32,49,76,109
5,0,0,75,1680,1121,2246,2032,9487
